NO ./textures/brick.xpm           
SO ./textures/grass.xpm                               
WE ./textures/metal.xpm                            
EA                                       ./textures/stone.xpm
F                                                                       00000000000,00000000000,000000000000000000000000000





















C 255,255,255


    1111111111111111111111111
    11 1000000110000000000001
    1111000001110000000000001
    100100000000000000000001
11111111111111111111111111111
10010111111111011100000010001
10010111111111011101010010001
11000000110101011100000010001
10000000000000001100000010001
10000000000000001101010010001
110000011101010111110111100011
1111N111 1110101 101111010001
11111111 1111111 111111111111


