NO ./textures/brick.xpm
SO ./textures/grass.xpm
WE ./textures/metal.xpm
EA ./textures/stone.xpm
F 220,100,0
C 225,30,0

    1111111111111111111111111
    1000000000110000000000001
    1000000000000000000000001
    1001000000000000000000001
1111100000000000000000000000011111
10010000000000000000000000001
10000000000000000000000000001
10000000000000000000000000001
10000000000000000000000000001
10000000000000000000000000001
10000000000000000000000000001
10000000000000000000000000001
10000000000000000000000000001
11000000000000000000000000001
10002000000000001100000000001
10000000000000001101010000001
1100000111010101111101110000111
11110111 1110101 101111000N01
11111111 1111111 111111111111
