R 600 600
NO ./path_to_the_north_texture
SO ./path_to_the_south_texture
WE ./path_to_the_west_texture




EA ./path_to_the_east_texture
S ./path_to_the_sprite_texture
F 220,100,0
C 225,30,0

11111111111
11111110011
11111111011
11111120011
11110000011
11110020111
11110000111
11000001111
10002011111
10000011111
11111111111
